NO ./assets/textures/wall.png
EA ./assets/textures/wall.png
SO ./assets/textures/wall.png
WE ./assets/textures/wall.png

F 45,45,65

11111
10001
10101
1N101
11111
