F 45,45,65 C 25,25,55 NO ./assets/textures/wall_red_dark.png EA ./assets/textures/wall_green_dark.png SO ./assets/textures/wall_blue_dark.png WE ./assets/textures/wall_yellow_dark.png



  11111    111     111     11111     1111111   111   11111
1110001   110111111101111111010111111100010111110111110001
1000101111100000000001000001000001000101000000000001000001
10S0101000000011101111011100000001010100000100000001000111
100010100000001 10000001 1000000011100010001000100011101
101010000011111 10001001 100110001 1000100010011100110011
10001000001     10000001 100010001 10001101111111101000011
11111011101     100100011111010011110001100010000000000001
    101 101   1110010000000100001  10001000010000011100011
    10111011111000010000000100001111001100001000001 100011
    1000000000000001000110011000000101 1011010010011111111
    111111111111111111111111111111111  111111111111


