NO ./assets/textures/wall_red.png
EA ./assets/textures/wall_green.png
SO ./assets/textures/wall_blue.png
WE ./assets/textures/wall_yellow.png

F 45,45,65
C 65,65,75

11111111111111111111       111      1111111111
10000000001000000101       101     100000000011
10000000001000000001       111      11111110001
10000000001000000101                      11011
100000000011100001011111111111111111111    101
100000000000001111010000010000000000001    101
100000000010000000010111000000000000001   11011
1000000000100010000101 101000000000000111110001
10000000001110100001011101000000000000000000001
10000000001000100000000001000111000000111110001
111111111110111111110111010100000000001   11101
          101      10000000100N00000001   10001
    11111 101 111  10100000100000000001   10111
    1000111011101  1010000010111000000111110001
    1000000000001  1110111010100000000000000001
    1000111011111  10001 1010001000000111110001
    11111 111      11111 11111111111111   11111
