NO ./assets/textures/wall.png
EA ./assets/textures/wall.png
SO ./assets/textures/wall.png
WE ./assets/textures/wall.png

F 45,45,65
C 65,65,75

11111111111
10000000001
10000000001
10000000001
10001110001
10001N10001
10001010001
10000000001
10000000001
10000000001
11111111111
