NO ./assets/textures/wall.png
EA ./assets/textures/wall.png
SO ./assets/textures/wall.png
WE ./assets/textures/wall.png

F 45,45,65
C 65,65,75

11111111111111111111                1111111111
10000000001000000101               100000000011
10000000001000000001                11111110001
10000000001000000101                      11011
100000000011100001011111111111111111111    101
100000000000001111010000000000000000001    101
100000000010000000010000000000000000001   11011
10000000001000100001000000000000000000111110001
10000000001110100001000000000000000000000000001
10000000001000100000000000000000000000111110001
111111111110111111110000000000000000001   11101
          101      10000000000N00000001   10001
    11111 101 111  10000000000000000001   10111
    1000111011101  1000000000000000000111110001
    1000000000001  1000000000000000000000000001
    1000111011111  1000000000000000000111110001
    11111 111      11111111111111111111   11111
